111111111111111111111111111111111
1111111111111000C0000000011111111
111100000000C000000C000P000000001
1E00000000P000000C101010101010101
111111111111111111111111111111111
111111111111111111111111111111111
111111111111111111111111111111111